113 35 4 109 16
7 7 7 7 7 7 7 7 7 7 7 7 7 7 7 7 7 7 7 7 7 7 7 7 7 7 7 7 7 7 7 7 7 7 7 
7 0 0 0 0 0 0 0 0 0 1 0 2 0 3 0 4 0 5 0 0 5 0 0 0 0 0 0 0 0 0 0 0 0 7 
7 0 0 0 0 0 0 0 0 0 1 0 2 0 3 0 4 0 5 0 5 5 0 0 0 0 0 0 0 0 0 0 0 0 7 
7 0 0 0 0 6 6 0 0 1 0 2 0 3 0 4 0 5 0 5 5 5 5 5 5 5 5 5 5 5 5 5 5 9 7 
7 0 0 0 0 6 6 0 0 1 0 2 0 3 0 4 0 5 0 5 5 5 5 5 5 5 5 5 5 5 5 5 5 5 7 
7 0 0 0 0 0 0 0 0 0 1 0 2 0 3 0 4 0 5 0 5 5 0 0 0 0 0 0 0 0 0 0 0 0 7 
7 0 0 0 0 0 0 0 0 0 1 0 2 0 3 0 4 0 5 0 0 5 0 0 0 0 0 0 0 0 0 0 0 0 7 
7 0 0 0 7 7 7 7 7 7 7 7 7 7 7 7 7 7 7 7 7 7 7 7 7 7 7 7 7 7 7 7 7 7 7 
7 3 4 3 4 3 4 0 0 0 0 0 0 0 0 0 0 5 5 0 0 0 0 0 0 0 0 0 0 0 0 0 0 0 7 
7 4 3 4 3 4 0 0 0 5 5 0 0 0 0 0 5 5 5 0 0 0 0 0 0 0 0 0 0 0 0 0 0 0 7 
7 3 4 3 4 0 0 0 0 5 5 5 0 0 0 5 5 5 0 0 0 0 0 0 0 0 0 0 0 0 0 0 0 0 7 
7 4 3 4 0 0 0 0 0 0 5 5 5 0 5 5 5 0 0 0 0 0 0 0 0 0 0 0 0 0 0 0 0 0 7 
7 3 4 0 0 0 0 0 0 0 0 5 5 5 5 5 5 0 0 0 0 0 3 2 3 2 3 2 3 2 3 2 3 2 7 
7 4 0 0 0 0 0 0 0 0 0 0 5 5 5 5 5 5 0 0 0 0 3 3 3 3 3 3 3 3 3 3 3 3 7 
7 0 0 0 0 0 0 0 0 0 0 5 5 5 5 5 5 5 5 0 0 0 3 0 0 3 0 0 3 0 0 0 3 0 7 
7 0 0 0 0 0 0 0 0 0 5 5 5 5 5 5 5 5 5 5 0 0 3 3 3 3 3 3 3 3 3 3 3 3 7 
7 0 0 0 0 0 0 0 0 5 5 5 5 5 5 5 3 3 3 5 5 0 0 3 0 3 0 0 0 0 3 0 0 3 7 
7 0 0 0 0 0 0 0 5 5 5 0 0 4 5 5 3 9 3 5 5 5 0 0 3 3 3 3 3 3 3 3 3 3 7 
7 0 0 0 0 0 0 0 5 5 0 0 0 0 4 5 3 3 3 5 5 5 5 0 0 3 0 0 3 0 0 0 3 0 7 
7 0 0 0 0 0 0 0 3 3 3 3 3 3 0 4 5 5 5 5 5 5 5 5 0 3 3 3 3 3 3 3 3 3 7 
7 0 0 0 0 0 0 0 3 0 0 0 0 3 3 0 4 5 5 5 5 5 5 5 0 0 0 0 0 0 0 0 0 0 7 
7 0 0 0 0 0 0 0 3 3 3 3 3 3 0 3 0 4 5 5 5 5 5 5 0 0 0 0 0 0 0 0 0 0 7 
7 0 0 0 0 0 0 0 3 0 0 0 0 3 3 0 3 0 4 5 5 5 5 4 0 0 0 8 8 8 8 8 0 0 7 
7 0 0 0 0 0 0 0 3 3 3 3 3 3 3 3 3 3 0 4 5 5 4 4 0 0 8 8 8 8 8 8 8 8 7 
7 0 0 0 0 0 0 0 0 0 0 0 0 0 0 0 0 0 0 0 0 0 0 0 0 0 8 8 8 0 8 8 0 8 7 
7 0 1 1 1 1 1 1 1 1 1 1 1 1 1 1 1 1 1 1 0 0 0 0 0 8 8 8 8 8 8 8 8 8 7 
7 0 1 1 1 1 1 1 1 1 1 1 1 1 1 1 1 1 1 1 0 0 0 0 8 8 8 8 0 8 8 8 8 8 7 
7 0 1 1 1 1 1 1 1 1 1 1 1 1 1 1 1 1 1 1 0 0 0 0 8 8 8 8 8 8 8 0 8 8 7 
7 0 0 0 0 0 0 0 0 0 0 0 0 0 0 0 0 0 0 0 0 0 0 0 8 8 8 8 0 8 8 8 8 8 7 
7 3 3 3 3 3 3 3 3 3 3 3 3 3 3 3 3 3 3 3 3 3 3 3 3 3 3 3 8 8 8 3 3 3 7 
7 3 3 3 3 3 3 3 3 3 3 3 3 3 3 3 3 3 3 3 3 3 3 3 3 3 3 3 0 0 0 3 3 3 7 
7 3 3 3 3 3 3 3 3 3 3 3 3 3 3 3 3 3 3 3 3 3 3 3 3 3 3 3 0 0 0 3 3 3 7 
7 3 3 3 0 0 0 0 0 0 0 0 0 0 0 0 0 0 0 0 0 0 0 0 0 3 3 3 0 0 0 3 3 3 7 
7 3 3 3 0 0 0 0 0 0 0 0 0 0 0 0 0 0 0 0 0 0 0 0 0 3 3 3 0 0 0 3 3 3 7 
7 3 3 3 0 0 0 0 0 0 0 0 0 0 0 0 0 0 0 0 0 0 0 0 0 3 3 3 0 0 0 3 3 3 7 
7 0 0 0 0 0 0 3 3 3 3 3 3 3 3 3 3 3 3 3 3 3 0 0 0 3 3 3 0 0 0 3 3 3 7 
7 0 0 0 0 0 0 3 3 3 3 3 3 3 3 3 3 3 3 3 3 3 0 0 0 3 3 3 0 0 0 3 3 3 7 
7 0 0 0 0 0 0 3 3 3 3 3 3 3 3 3 3 3 3 3 3 3 0 0 0 3 3 3 0 0 0 3 3 3 7 
7 0 0 0 3 3 3 3 3 3 0 0 0 0 0 0 0 0 0 3 3 3 0 0 0 3 3 3 0 0 0 3 3 3 7 
7 0 0 0 3 3 3 3 3 3 0 0 0 0 0 0 0 0 0 3 3 3 0 0 0 3 3 3 0 0 0 3 3 3 7 
7 0 0 0 3 3 3 3 3 3 0 0 0 0 0 0 0 0 0 3 3 3 0 0 0 3 3 3 0 0 0 3 3 3 7 
7 0 0 0 0 0 0 0 0 0 0 0 0 3 3 3 0 0 0 3 3 3 0 0 0 0 0 0 0 0 0 3 3 3 7 
7 0 0 0 0 0 0 0 0 0 0 0 0 3 3 3 0 0 0 3 3 3 0 0 0 0 0 0 0 0 0 3 3 3 7 
7 0 0 0 0 0 0 0 0 0 0 0 0 3 3 3 0 0 0 3 3 3 0 0 0 0 0 0 0 0 0 3 3 3 7 
7 7 7 7 7 7 7 7 7 7 7 7 7 7 7 0 0 0 0 0 7 7 7 7 7 7 7 7 7 7 7 7 7 7 7 
7 8 8 8 8 8 8 8 8 8 8 8 0 0 0 8 8 8 8 8 8 8 8 8 8 8 0 0 0 8 8 8 8 8 7 
7 0 0 8 8 8 8 8 8 8 8 8 0 0 8 8 8 8 8 8 8 8 8 8 0 8 8 8 8 8 8 8 8 8 7 
7 0 0 8 8 8 8 8 8 8 8 8 8 0 8 8 8 8 8 8 8 8 8 8 8 8 8 8 8 8 8 8 8 8 7 
7 0 0 8 8 8 0 8 8 8 8 8 8 8 8 8 8 6 8 8 8 8 8 8 8 8 8 8 8 8 0 8 8 8 7 
7 0 8 8 8 8 8 8 8 8 8 8 8 8 8 8 8 8 8 8 8 8 8 8 8 8 8 8 0 8 8 8 8 8 7 
7 0 8 8 8 8 8 8 8 8 8 8 8 8 8 8 8 8 8 8 8 0 8 8 8 8 8 8 8 8 8 8 8 8 7 
7 0 8 8 8 8 8 8 8 8 8 8 8 8 8 2 8 0 8 2 8 0 0 0 0 8 8 8 8 8 8 8 8 8 7 
7 0 0 0 8 8 8 8 8 8 8 8 2 3 3 3 3 3 3 3 3 3 2 0 0 0 0 0 8 8 8 8 0 0 7 
7 0 0 0 0 0 0 0 0 0 0 0 0 3 3 3 3 3 3 3 3 3 0 0 0 0 0 0 8 8 8 8 0 0 7 
7 3 3 3 3 3 3 3 3 3 3 3 2 3 3 3 3 3 3 3 3 3 2 3 3 3 3 3 3 3 3 3 3 3 7 
7 3 0 0 0 0 0 0 0 0 0 0 0 3 3 3 3 3 3 3 3 3 0 0 0 0 0 0 0 0 0 0 0 3 7 
7 3 3 3 3 3 3 3 3 3 3 3 2 3 3 3 3 9 3 3 3 3 2 3 3 3 3 3 3 3 3 3 3 3 7 
7 3 0 0 0 0 0 0 0 0 0 0 0 3 3 3 3 3 3 3 3 3 0 0 0 0 0 0 0 0 0 0 0 3 7 
7 3 3 3 3 3 3 3 3 3 3 3 2 3 3 3 3 3 3 3 3 3 2 3 3 3 3 3 3 3 3 3 3 3 7 
7 0 0 0 0 0 0 0 0 0 0 0 0 3 3 3 3 3 3 3 3 3 0 0 0 0 0 0 0 0 0 0 0 0 7 
7 0 0 0 0 0 0 0 0 0 0 0 2 3 3 3 3 3 3 3 3 3 2 0 0 0 0 0 0 0 0 0 0 0 7 
7 0 0 0 0 0 0 0 0 0 0 0 0 0 0 2 0 0 0 2 0 0 0 0 0 0 0 0 0 0 0 0 0 0 7 
7 0 0 0 0 0 0 0 0 0 0 0 0 0 0 0 1 1 1 0 0 0 0 0 0 0 0 0 0 0 0 0 0 0 7 
7 1 1 1 0 0 0 0 0 0 0 0 0 0 0 0 1 1 1 0 0 0 0 0 0 0 0 0 0 0 0 1 1 1 7 
7 1 1 1 0 0 0 0 0 0 0 0 0 0 0 0 1 1 1 0 0 0 0 0 0 0 0 0 0 0 0 1 1 1 7 
7 1 1 1 0 1 1 1 0 0 1 1 1 0 0 0 0 0 0 0 0 0 1 1 1 0 0 1 1 1 0 1 1 1 7 
7 0 0 0 0 1 1 1 0 0 1 1 1 0 0 0 0 0 0 0 0 0 1 1 1 0 0 1 1 1 0 0 0 0 7 
7 0 0 0 0 1 1 1 0 0 1 1 1 0 0 0 0 0 0 0 0 0 1 1 1 0 0 1 1 1 0 0 0 0 7 
7 1 1 1 0 0 0 0 0 0 0 0 0 1 1 1 0 0 0 1 1 1 0 0 0 0 0 0 0 0 0 1 1 1 7 
7 1 1 1 0 1 1 1 0 0 0 0 0 1 1 1 0 0 0 1 1 1 0 0 0 0 0 1 1 1 0 1 1 1 7 
7 1 1 1 0 1 1 1 0 1 1 1 0 1 1 1 0 0 0 1 1 1 0 1 1 1 0 1 1 1 0 1 1 1 7 
7 0 0 0 0 1 1 1 0 1 1 1 0 0 0 0 1 1 1 0 0 0 0 1 1 1 0 1 1 1 0 0 0 0 7 
7 0 0 0 0 0 0 0 0 1 1 1 0 0 0 0 1 1 1 0 0 0 0 1 1 1 0 0 0 0 0 0 0 0 7 
7 0 0 0 0 0 0 0 0 0 0 0 0 0 0 0 1 1 1 0 0 0 0 0 0 0 0 0 0 0 0 0 0 0 7 
7 0 0 0 7 7 7 7 7 7 7 7 7 7 7 7 7 7 7 7 7 7 7 7 7 7 7 7 7 7 7 0 0 0 7 
7 3 3 3 3 0 1 1 1 0 0 0 0 0 0 0 0 0 0 0 0 0 0 0 0 1 1 1 0 0 3 3 3 3 7 
7 3 3 3 0 0 1 1 1 0 0 0 0 0 0 0 0 0 0 0 0 0 0 0 0 1 1 1 0 0 0 3 3 3 7 
7 3 3 0 0 0 1 1 1 0 0 0 0 0 0 0 0 0 0 0 0 0 0 0 0 1 1 1 0 0 8 0 3 3 7 
7 3 8 8 0 0 1 1 1 0 0 0 0 3 1 3 1 3 1 3 1 3 0 0 0 1 1 1 0 8 8 8 0 3 7 
7 8 2 8 0 0 1 1 1 0 0 0 0 1 3 1 3 1 3 1 3 1 0 0 0 1 1 1 0 2 8 2 8 8 7 
7 8 8 8 8 0 1 1 1 0 0 0 0 3 1 3 3 3 3 3 1 3 0 0 0 1 1 1 8 0 8 8 8 8 7 
7 8 8 0 2 8 1 1 1 0 0 0 0 1 3 3 1 1 1 3 3 1 0 0 0 1 1 1 2 8 6 8 6 8 7 
7 8 6 8 8 8 1 1 1 0 0 0 0 3 1 3 1 9 1 3 1 3 0 0 0 1 1 1 8 8 6 8 8 8 7 
7 0 8 6 6 0 1 1 1 0 0 0 0 1 3 3 1 1 1 3 3 1 0 0 0 1 1 1 8 8 6 6 6 8 7 
7 8 6 6 8 8 1 1 1 0 0 0 0 3 1 3 3 3 3 3 1 3 0 0 0 1 1 1 8 8 8 8 8 8 7 
7 8 0 0 8 2 1 1 1 0 0 0 0 1 3 1 3 1 3 1 3 1 0 0 0 1 1 1 2 8 2 0 8 8 7 
7 8 8 8 8 0 1 1 1 0 0 0 0 3 1 3 1 3 1 3 1 3 0 0 0 1 1 1 0 2 8 8 8 8 7 
7 8 8 2 8 0 1 1 1 0 0 0 0 0 0 0 0 0 0 0 0 0 0 0 0 1 1 1 0 0 2 8 8 8 7 
7 8 2 8 2 0 1 1 1 1 1 1 1 1 1 1 1 1 1 1 1 1 1 1 1 1 1 1 0 0 0 0 8 0 7 
7 8 2 8 0 0 1 1 1 1 1 1 1 1 1 1 1 1 1 1 1 1 1 1 1 1 1 1 0 0 0 0 0 0 7 
7 0 0 0 0 0 1 1 1 1 1 1 1 1 1 1 1 1 1 1 1 1 1 1 1 1 1 1 0 0 0 0 0 0 7 
7 0 0 0 0 0 1 1 1 0 0 0 0 0 8 0 0 8 0 8 8 0 0 0 0 1 1 1 0 0 0 0 0 0 7 
7 0 0 0 0 0 2 2 2 0 0 0 0 0 0 8 8 8 8 8 0 0 0 0 0 2 2 2 0 0 0 0 0 0 7 
7 0 0 0 0 0 2 2 2 0 0 0 0 0 8 0 8 8 0 8 8 0 0 0 0 2 2 2 0 0 0 0 0 0 7 
7 0 0 0 0 0 2 2 2 0 0 0 0 0 0 8 8 0 8 8 8 0 0 0 0 2 2 2 0 0 0 0 0 0 7 
7 7 7 7 7 7 7 7 7 7 7 7 7 7 7 7 8 8 8 7 7 7 7 7 7 7 7 7 7 7 7 7 7 7 7 
7 0 0 0 0 0 0 0 0 0 0 0 0 0 8 8 8 0 8 8 0 0 0 0 0 0 0 0 0 0 0 0 0 0 7 
7 0 0 0 0 0 0 0 0 0 0 0 0 0 0 8 0 8 8 0 8 0 0 0 0 0 0 0 0 0 0 0 0 0 7 
7 1 1 1 1 1 1 1 1 1 1 1 1 1 1 1 1 1 1 1 1 1 1 1 1 1 1 1 1 1 1 1 1 1 7 
7 1 1 1 1 1 1 1 1 1 1 1 1 1 1 1 1 1 1 1 1 1 1 1 1 1 1 1 1 1 1 1 1 1 7 
7 1 1 1 1 1 1 1 1 1 1 1 1 1 1 1 1 1 1 1 1 1 1 1 1 1 1 1 1 1 1 1 1 1 7 
7 0 0 0 0 0 0 0 0 0 0 0 0 0 0 0 0 0 0 0 0 0 0 0 0 0 0 0 0 0 0 0 0 0 7 
7 0 0 0 0 0 0 0 0 0 0 0 0 0 0 0 0 0 0 0 0 0 0 0 0 0 0 0 0 0 0 0 0 0 7 
7 0 0 0 0 0 0 0 0 0 0 0 0 1 1 1 1 1 1 1 1 1 0 0 0 0 0 0 0 0 0 0 0 0 7 
7 0 0 0 0 1 1 1 0 0 0 0 0 1 1 1 1 1 1 1 1 1 0 0 0 0 0 1 1 1 0 0 0 0 7 
7 0 0 0 0 1 1 1 0 0 0 0 0 1 1 1 1 1 1 1 1 1 0 0 0 0 0 1 1 1 0 0 0 0 7 
7 0 0 0 0 1 1 1 0 0 1 1 1 0 0 0 0 0 0 0 0 0 1 1 1 0 0 1 1 1 0 0 0 0 7 
7 0 0 0 0 0 0 0 0 0 1 1 1 0 0 0 0 0 0 0 0 0 1 1 1 0 0 0 0 0 0 0 0 0 7 
7 5 0 0 0 0 0 0 0 0 1 1 1 0 0 0 0 0 0 0 0 0 1 1 1 0 0 0 0 0 0 0 0 5 7 
7 5 5 0 0 0 0 0 0 0 1 1 1 0 0 0 0 0 0 0 0 0 1 1 1 0 0 0 0 0 0 0 5 5 7 
7 5 6 5 0 0 0 0 0 0 1 1 1 0 0 0 0 0 0 0 0 0 1 1 1 0 0 0 0 0 0 5 6 5 7 
7 5 5 5 5 0 0 0 0 0 1 1 1 0 0 0 0 0 0 0 0 0 1 1 1 0 0 0 0 0 5 5 5 5 7 
7 7 7 7 7 7 7 7 7 7 7 7 7 7 7 7 7 7 7 7 7 7 7 7 7 7 7 7 7 7 7 7 7 7 7 
