47 47 3 43 22
7 7 7 7 7 7 7 7 7 7 7 7 7 7 7 7 7 7 7 7 7 7 7 7 7 7 7 7 7 7 7 7 7 7 7 7 7 7 7 7 7 7 7 7 7 7 7 
7 0 0 0 0 0 0 0 0 0 0 0 0 0 0 0 0 0 0 5 5 5 5 5 5 5 5 5 0 0 0 0 0 0 0 0 0 0 0 0 0 0 0 0 0 0 7 
7 0 0 0 0 0 0 0 0 0 0 0 0 0 0 0 0 0 0 5 5 5 5 5 5 5 5 5 0 0 0 0 0 0 0 0 0 0 0 0 0 0 0 0 0 0 7 
7 0 0 0 0 0 0 0 0 0 0 0 0 0 0 0 0 0 0 5 5 5 5 5 5 5 5 5 0 0 0 0 0 0 0 0 0 0 0 0 0 0 0 0 0 0 7 
7 0 0 0 3 3 3 3 3 3 3 3 3 0 0 0 5 5 5 3 3 3 3 3 3 3 3 3 5 5 5 0 0 0 3 3 3 3 3 3 3 3 3 0 0 0 7 
7 0 0 0 3 3 3 3 3 3 3 3 3 0 0 0 5 5 5 3 3 3 3 3 3 3 3 3 5 5 5 0 0 0 3 3 3 3 3 3 3 3 3 0 0 0 7 
7 0 0 0 3 3 5 5 5 5 5 3 3 0 0 0 5 5 5 3 3 5 5 5 5 5 3 3 5 5 5 0 0 0 3 3 5 5 5 5 5 3 3 0 0 0 7 
7 0 0 0 3 3 5 1 1 1 5 3 3 0 0 0 5 5 5 3 3 5 1 1 1 5 3 3 5 5 5 0 0 0 3 3 5 1 1 1 5 3 3 0 0 0 7 
7 0 0 0 3 3 5 1 9 1 5 3 3 0 0 0 5 5 5 3 3 5 1 9 1 5 3 3 5 5 5 0 0 0 3 3 5 1 9 1 5 3 3 0 0 0 7 
7 0 0 0 3 3 5 1 1 1 5 3 3 0 0 0 5 5 5 3 3 5 1 1 1 5 3 3 5 5 5 0 0 0 3 3 5 1 1 1 5 3 3 0 0 0 7 
7 0 0 0 3 3 5 5 5 5 5 3 3 0 0 0 5 5 5 3 3 5 5 5 5 5 3 3 5 5 5 0 0 0 3 3 5 5 5 5 5 3 3 0 0 0 7 
7 0 0 0 3 3 3 3 3 3 3 3 3 0 0 0 5 5 5 3 3 3 3 3 3 3 3 3 5 5 5 0 0 0 3 3 3 3 3 3 3 3 3 0 0 0 7 
7 0 0 0 3 3 3 3 3 3 3 3 3 0 0 0 5 5 5 3 3 3 3 3 3 3 3 3 5 5 5 0 0 0 3 3 3 3 3 3 3 3 3 0 0 0 7 
7 0 0 0 0 0 0 0 0 0 0 0 0 0 0 0 0 0 0 5 5 5 5 5 5 5 5 5 0 0 0 0 0 0 0 0 0 0 0 0 0 0 0 0 0 0 7 
7 0 0 0 0 0 0 0 0 0 0 0 0 0 0 0 0 0 0 5 5 5 5 5 5 5 5 5 0 0 0 0 0 0 0 0 0 0 0 0 0 0 0 0 0 0 7 
7 0 0 0 0 0 0 0 0 0 0 0 0 0 0 0 0 0 0 5 5 5 5 5 5 5 5 5 0 0 0 0 0 0 0 0 0 0 0 0 0 0 0 0 0 0 7 
7 1 1 1 1 1 1 1 1 1 1 1 1 1 1 1 1 1 1 1 1 1 1 1 1 1 1 1 1 1 1 1 1 1 1 1 1 1 1 1 1 1 1 1 1 1 7 
7 1 1 1 1 1 1 1 1 1 1 1 1 1 1 1 1 1 1 1 1 1 1 1 1 1 1 1 1 1 1 1 1 1 1 1 1 1 1 1 1 1 1 1 1 1 7 
7 6 6 6 6 6 1 1 6 1 1 1 6 1 1 1 6 1 6 1 1 6 1 6 6 1 1 1 1 6 1 1 6 6 6 6 6 6 1 6 1 1 1 6 6 6 7 
7 1 1 6 1 1 1 6 1 6 1 1 6 6 1 1 6 1 6 1 6 1 1 6 1 6 1 1 6 1 6 1 1 6 1 1 6 1 1 6 1 1 1 6 1 1 7 
7 1 1 6 1 1 1 6 6 6 1 1 6 1 6 1 6 1 6 6 1 1 1 6 6 1 1 1 6 6 6 1 1 6 1 1 6 1 1 6 1 1 1 6 6 6 7 
7 1 1 6 1 1 6 1 1 1 6 1 6 1 1 6 6 1 6 1 6 1 1 6 1 6 1 6 1 1 1 6 1 6 1 1 6 1 1 6 1 1 1 6 1 1 7 
7 1 1 6 1 1 6 1 1 1 6 1 6 1 1 1 6 1 6 1 1 6 1 6 6 1 1 6 1 1 1 6 1 6 1 1 6 1 1 6 6 6 1 6 6 6 7 
7 1 1 1 1 1 1 1 1 1 1 1 1 1 1 1 1 1 1 1 1 1 1 1 1 1 1 1 1 1 1 1 1 1 1 1 1 1 1 1 1 1 1 1 1 1 7 
7 1 1 1 1 1 1 1 1 1 1 1 1 1 1 1 1 1 1 1 1 1 1 1 1 1 1 1 1 1 1 1 1 1 1 1 1 1 1 1 1 1 1 1 1 1 7 
7 0 0 0 1 1 1 0 0 0 1 1 1 0 0 0 0 0 0 0 0 0 0 0 0 0 0 0 0 0 0 0 0 0 1 1 1 0 0 0 1 1 1 0 0 0 7 
7 0 0 0 1 1 1 0 0 0 1 1 1 0 0 0 0 0 0 0 0 0 0 0 0 0 0 0 0 0 0 0 0 0 1 1 1 0 0 0 1 1 1 0 0 0 7 
7 0 0 0 1 1 1 0 0 0 1 1 1 0 0 0 0 0 0 0 0 0 0 0 0 0 0 0 0 0 0 0 0 0 1 1 1 0 0 0 1 1 1 0 0 0 7 
7 1 1 1 1 1 1 1 1 1 1 1 1 1 1 1 1 1 1 1 1 1 1 1 1 1 1 1 1 1 1 1 1 1 1 1 1 1 1 1 1 1 1 1 1 1 7 
7 1 1 1 1 1 1 1 1 1 1 1 1 1 1 1 1 1 1 1 1 1 1 1 1 1 1 1 1 1 1 1 1 1 1 1 1 1 1 1 1 1 1 1 1 1 7 
7 1 1 1 1 1 1 1 1 1 1 1 1 1 1 1 1 1 1 1 1 1 1 1 1 1 1 1 1 1 1 1 1 1 1 1 1 1 1 1 1 1 1 1 1 1 7 
7 0 0 0 1 1 1 0 0 0 1 1 1 0 0 0 0 0 0 0 0 0 0 0 0 0 0 0 0 0 0 0 0 0 1 1 1 0 0 0 1 1 1 0 0 0 7 
7 0 0 0 1 1 1 0 0 0 1 1 1 0 0 0 0 0 0 0 0 0 0 0 0 0 0 0 0 0 0 0 0 0 1 1 1 0 0 0 1 1 1 0 0 0 7 
7 0 0 0 1 1 1 0 0 0 1 1 1 0 0 0 0 0 0 0 0 0 0 0 0 0 0 0 0 0 0 0 0 0 1 1 1 0 0 0 1 1 1 0 0 0 7 
7 0 0 0 1 1 1 0 0 0 1 1 1 0 0 0 0 0 0 8 8 8 8 8 8 8 8 8 0 0 0 0 0 0 1 1 1 0 0 0 1 1 1 0 0 0 7 
7 0 0 0 1 1 1 0 0 0 1 1 1 0 0 0 0 0 0 8 8 8 8 8 8 8 8 8 0 0 0 0 0 0 1 1 1 0 0 0 1 1 1 0 0 0 7 
7 0 0 0 1 1 1 0 0 0 1 1 1 0 0 0 0 0 0 8 8 8 8 8 8 8 8 8 0 0 0 0 0 0 1 1 1 0 0 0 1 1 1 0 0 0 7 
7 0 0 0 1 1 1 0 0 0 1 1 1 0 0 0 8 8 8 0 0 0 0 0 0 0 0 0 8 8 8 0 0 0 1 1 1 0 0 0 1 1 1 0 0 0 7 
7 0 0 0 1 1 1 0 0 0 1 1 1 0 0 0 8 8 8 0 0 0 0 0 0 0 0 0 8 8 8 0 0 0 1 1 1 0 0 0 1 1 1 0 0 0 7 
7 0 0 0 1 1 1 0 0 0 1 1 1 0 0 0 8 8 8 0 0 0 0 0 0 0 0 0 8 8 8 0 0 0 1 1 1 0 0 0 1 1 1 0 0 0 7 
7 0 0 0 1 1 1 0 0 0 1 1 1 0 0 0 8 8 8 0 0 0 0 0 0 0 0 0 8 8 8 0 0 0 1 1 1 0 0 0 1 1 1 0 0 0 7 
7 0 0 0 1 1 1 0 0 0 1 1 1 0 0 0 8 8 8 0 0 0 0 0 0 0 0 0 8 8 8 0 0 0 1 1 1 0 0 0 1 1 1 0 0 0 7 
7 0 0 0 1 1 1 0 0 0 1 1 1 0 0 0 8 8 8 0 0 0 0 0 0 0 0 0 8 8 8 0 0 0 1 1 1 0 0 0 1 1 1 0 0 0 7 
7 0 0 0 1 1 1 0 0 0 1 1 1 0 0 0 8 8 8 0 0 0 0 0 0 0 0 0 8 8 8 0 0 0 1 1 1 0 0 0 1 1 1 0 0 0 7 
7 0 0 0 1 1 1 0 0 0 1 1 1 0 0 0 8 8 8 0 0 0 0 0 0 0 0 0 8 8 8 0 0 0 1 1 1 0 0 0 1 1 1 0 0 0 7 
7 0 0 0 1 1 1 0 0 0 1 1 1 0 0 0 8 8 8 0 0 0 0 0 0 0 0 0 8 8 8 0 0 0 1 1 1 0 0 0 1 1 1 0 0 0 7 
7 7 7 7 7 7 7 7 7 7 7 7 7 7 7 7 7 7 7 7 7 7 7 7 7 7 7 7 7 7 7 7 7 7 7 7 7 7 7 7 7 7 7 7 7 7 7 